31
25
72,72,72,72,72,72,72,72,72,72,72,72,72,74,74,74,72,72,72,72,72,72,72,72,72,72,72,72,72,72
72,72,72,72,72,72,72,72,72,72,72,72,72,74,74,74,72,72,72,72,72,72,72,72,72,72,72,72,72,72
72,72,72,72,72,72,72,72,72,72,72,72,72,74,74,74,72,72,72,72,72,72,72,72,72,72,72,72,72,72
72,72,72,72,72,72,72,72,-660,-661,-660,-661,72,74,74,74,72,72,72,72,72,72,72,72,72,72,72,72,72,72,72
72,72,72,72,72,72,72,72,-692,-693,-692,-693,72,74,74,74,72,72,72,72,72,72,72,72,72,72,72,72,72,72
72,72,-1411,72,72,72,72,72,-724,-725,-724,-725,72,74,74,74,74,74,74,74,74,74,72,72,72,72,72,72,72,72
72,-1411,72,-1411,72,72,72,72,-756,-757,-756,-757,72,74,74,74,72,72,72,72,72,72,72,72,72,72,72,72,72,72
-1411,72,72,72,-1411,74,74,74,74,74,74,74,74,74,74,74,72,72,72,72,72,72,72,72,72,72,72,72,72,72
72,-1411,72,-1411,72,72,72,72,72,72,72,72,72,74,74,74,72,72,72,72,72,72,72,72,72,72,72,72,72,72
72,72,-1411,72,72,72,72,72,72,72,72,72,72,74,74,74,72,72,72,72,72,72,72,72,72,72,72,72,72,72
72,72,72,72,72,72,72,72,72,72,72,72,72,74,74,74,72,72,72,72,72,72,72,72,72,72,72,72,72,72
72,72,72,72,72,72,72,72,72,72,72,72,72,74,74,74,72,72,72,72,72,72,72,72,72,72,72,72,72,72
72,72,72,72,72,72,72,72,72,72,72,72,72,74,74,74,72,72,72,72,72,72,72,72,72,72,72,72,72,72
72,72,72,72,72,72,72,72,72,72,72,72,72,74,74,74,72,72,72,72,72,72,72,72,72,72,72,72,72,72
72,72,72,72,72,72,72,72,72,72,72,72,72,74,74,74,74,74,74,74,74,74,74,74,74,72,72,72,72,72
72,72,72,72,72,72,72,72,72,72,72,72,72,74,74,74,72,72,72,72,72,72,72,72,72,72,72,72,72,72
72,72,72,74,74,74,74,74,74,74,74,74,74,74,74,74,72,72,72,72,72,72,72,72,72,72,72,72,72,72
72,72,72,72,72,72,72,72,72,72,72,72,72,74,74,74,72,72,72,72,72,72,72,72,72,72,72,72,72,72
72,72,72,72,72,72,72,72,72,72,72,72,72,74,74,74,72,72,72,72,72,72,72,72,72,72,72,72,72,72
72,72,72,72,72,72,72,72,72,72,72,72,72,74,74,74,72,72,72,72,72,72,72,72,72,72,72,72,72,72
72,72,72,72,72,72,72,72,72,72,72,72,72,74,74,74,72,72,72,72,72,72,72,72,72,72,72,72,72,72
72,72,72,72,72,72,72,72,72,72,72,72,72,74,74,74,72,72,72,72,72,72,72,72,72,72,72,72,72,72
72,72,72,72,72,72,72,72,72,72,72,72,72,74,74,74,72,72,72,72,72,72,72,72,72,72,72,72,72,72
72,72,72,72,72,72,72,72,72,72,72,72,72,74,74,74,72,72,72,72,72,72,72,72,72,72,72,72,72,72
72,72,72,72,72,72,72,72,72,72,72,72,72,74,74,74,72,72,72,72,72,72,72,72,72,72,72,72,72,72
