31
25
72,72,72,72,72,72,72,72,72,72,72,72,72,74,74,74,72,72,72,72,72,72,72,72,72,-1350,-1414,-1415,-1414,-1415
72,72,72,72,72,72,72,72,72,72,72,72,72,74,74,74,72,-660,-661,-660,-661,72,72,72,72,-1382,-1446,-1447,-1446,-1447
72,72,72,72,72,72,72,72,72,72,72,72,72,74,74,74,72,-692,-693,-692,-693,72,72,72,72,-1350,-1414,-1415,-1414,-1415
72,72,72,72,72,72,72,72,-660,-661,-660,-661,72,74,74,74,72,-724,-725,-724,-725,72,72,72,72,-1382,-1446,-1447,-1446,-1447
72,72,72,72,72,72,72,72,-692,-693,-692,-693,72,74,74,74,72,-756,-757,-756,-757,-1420,-1423,-1422,72,72,-1382,-1383,-1382,-1383
72,72,72,72,72,-1332,-1301,-1302,-724,-725,-724,-725,72,74,74,74,74,74,74,74,74,74,74,74,74,74,72,72,72,72
72,72,72,72,72,-1332,-1333,-1334,-756,-757,-756,-757,72,74,74,74,74,74,74,74,74,74,74,74,74,74,72,72,72,72
72,72,72,74,74,74,74,74,74,74,74,74,74,74,74,74,72,72,72,72,72,72,72,72,72,72,72,72,72,72
72,72,72,74,74,74,74,74,74,74,74,74,74,74,74,74,72,72,72,72,72,72,72,72,72,72,72,72,72,72
72,72,72,72,72,72,72,72,72,72,72,72,72,74,74,74,72,72,72,72,72,72,72,72,72,72,72,72,72,72
72,72,72,72,72,72,72,72,72,72,72,72,72,74,74,74,72,72,72,72,72,-660,-661,-660,-661,72,72,72,72,72
72,72,72,72,72,72,72,72,72,72,72,72,72,74,74,74,72,72,72,72,72,-692,-693,-692,-693,72,72,72,72,72
72,72,72,-660,-661,-660,-661,72,72,72,72,72,72,74,74,74,72,72,72,-1274,-1274,-724,-725,-724,-725,72,72,72,72,72
72,72,72,-692,-693,-692,-693,72,72,72,72,72,72,74,74,74,72,72,72,-1502,-1503,-756,-757,-756,-757,72,72,72,72,72
72,72,-1823,-724,-725,-724,-725,-1146,72,72,72,72,72,74,74,74,74,74,74,74,74,74,74,74,74,72,72,72,72,72
72,72,-1855,-756,-757,-756,-757,-1178,-1274,72,72,72,72,74,74,74,74,74,74,74,74,74,74,74,74,72,72,72,72,72
72,72,74,74,74,74,74,74,74,74,74,74,74,74,74,74,72,72,72,72,72,72,72,72,72,72,72,72,72,72
72,72,74,74,74,74,74,74,74,74,74,74,74,74,74,74,72,72,72,72,72,72,72,72,72,72,72,72,72,72
72,72,72,72,72,72,72,72,72,72,72,72,72,74,74,74,72,72,72,72,72,72,72,72,72,72,72,72,72,1186
72,72,72,72,72,72,72,72,72,72,72,72,72,74,74,74,72,72,72,72,72,72,72,72,72,72,72,72,72,1186
72,72,72,72,72,72,72,72,72,72,72,72,72,74,74,74,72,72,72,72,72,72,72,72,72,72,72,72,72,72
72,72,72,72,72,72,72,72,72,72,72,72,72,74,74,74,72,72,72,72,72,72,72,72,72,72,72,72,72,72
72,72,72,72,72,72,72,72,72,72,72,72,72,74,74,74,72,72,72,72,72,72,72,72,72,72,72,72,72,72
72,72,72,72,72,72,72,72,72,72,72,72,72,74,74,74,72,72,72,72,72,72,72,72,72,72,72,72,72,72
72,72,72,72,72,72,72,72,72,72,72,72,72,74,74,74,72,72,72,72,72,72,72,72,72,72,72,72,72,72