 30
 30
   -64,   -64,   -64,   -64,   -64,   -64,   -64,   -64,   -64,   -64,   -64,   -64,   -64,   -64,   -64,   -64,   -64,   -64,   -64,   -64,   -64,   -64,   -64,   -64,   -64,   -64,   -64,     8
   -64,    96,    96,    96,    96,    96,    96,    96,    96,    96,    96,    96,    96,    96,    96,    96,    96,    96,    96,    96,    96,    96,    96,    96,    96,    96,   -64,     8
   -64,    72,    72,    72,    72,    72,    72,    72,    72,    72,    72,    72,    72,    72,    72,    72,    72,    72,    72,    72,    72,    72,    72,    72,    72,    72,   -64,     8
   -64,    72,    72,    72,    72,    72,    72,    72,    72,    72,    72,    72,    72,    72,    72,    72,    72,    72,    72,    72,    72,    72,    72,    72,    72,    72,   -64,     8
   -64,    72,    72,    72,    72,    72,    72,    72,    72,    72,    72,    72,    72,    72,    72,    72,    72,    72,    72,    72,    72,    72,    72,    72,    72,    72,   -64,     8
   -64,    72,    72,    72,    72,    72,    72,    72,    72,    72,    72,    72,    72,    72,    72,    72,    72,    72,    72,    72,    72,    72,    72,    72,    72,    72,   -64,     8
   -64,    72,    72,    72,    72,    72,    72,    72,    72,    72,    72,    72,    72,    72,    72,    72,    72,    72,    72,    72,    72,    72,    72,    72,    72,    72,   -64,     8
   -64,    72,    72,    72,    72,    72,    72,    72,    72,    72,    72,    72,    72,    72,    72,    72,    72,    72,    72,    72,    72,    72,    72,    72,    72,    72,   -64,     8
   -64,    72,    72,    72,    72,    72,    72,    72,    72,    72,    72,    72,    72,    72,    72,    72,    72,    72,    72,    72,    72,    72,    72,    72,    72,    72,   -64,     8
   -64,    72,    72,    72,    72,    72,    72,    72,    72,    72,    72,    72,    72,    72,    72,    72,    72,    72,    72,    72,    72,    72,    72,    72,    72,    72,   -64,     8
   -64,    72,    72,    72,    72,    72,    72,    72,    72,    72,    72,    72,    72,    72,    72,    72,    72,    72,    72,    72,    72,    72,    72,    72,    72,    72,   -64,     8
   -64,    72,    72,    72,    72,    72,    72,    72,    72,    72,    72,    72,    72,    72,    72,    72,    72,    72,    72,    72,    72,    72,    72,    72,    72,    72,   -64,     8
   -64,    72,    72,    72,    72,    72,    72,    72,    72,    72,    72,    72,    72,    72,    72,    72,    72,    72,    72,    72,    72,    72,    72,    72,    72,    72,   -64,     8
   -64,    72,    72,    72,    72,    72,    72,    72,    72,    72,    72,    72,    72,    72,    72,    72,    72,    72,    72,    72,    72,    72,    72,    72,    72,    72,   -64,     8
   -64,    72,    72,    72,    72,    72,    72,    72,    72,    72,    72,    72,    72,    72,    72,    72,    72,    72,    72,    72,    72,    72,    72,    72,    72,    72,   -64,     8
   -64,    72,    72,    72,    72,    72,    72,    72,    72,    72,    72,    72,    72,    72,    72,    72,    72,    72,    72,    72,    72,    72,    72,    72,    72,    72,   -64,     8
   -64,    72,    72,    72,    72,    72,    72,    72,    72,    72,    72,    72,    72,    72,    72,    72,    72,    72,    72,    72,    72,    72,    72,    72,    72,    72,   -64,     8
   -64,    72,    72,    72,    72,    72,    72,    72,    72,    72,    72,    72,    72,    72,    72,    72,    72,    72,    72,    72,    72,    72,    72,    72,    72,    72,   -64,     8
   -64,    72,    72,    72,    72,    72,    72,    72,    72,    72,    72,    72,    72,    72,    72,    72,    72,    72,    72,    72,    72,    72,    72,    72,    72,    72,   -64,     8
   -64,    72,    72,    72,    72,    72,    72,    72,    72,    72,    72,    72,    72,    72,    72,    72,    72,    72,    72,    72,    72,    72,    72,    72,    72,    72,   -64,     8
   -64,    72,    72,    72,    72,    72,    72,    72,    72,    72,    72,    72,    72,    72,    72,    72,    72,    72,    72,    72,    72,    72,    72,    72,    72,    72,   -64,     8
   -64,    72,    72,    72,    72,    72,    72,    72,    72,    72,    72,    72,    72,    72,    72,    72,    72,    72,    72,    72,    72,    72,    72,    72,    72,    72,   -64,     8
   -64,    72,    72,    72,    72,    72,    72,    72,    72,    72,    72,    72,    72,    72,    72,    72,    72,    72,    72,    72,    72,    72,    72,    72,    72,    72,   -64,     8
   -64,    72,    72,    72,    72,    72,    72,    72,    72,    72,    72,    72,    72,    72,    72,    72,    72,    72,    72,    72,    72,    72,    72,    72,    72,    72,   -64,     8
   -64,    72,    72,    72,    72,    72,    72,    72,    72,    72,    72,    72,    72,    72,    72,    72,    72,    72,    72,    72,    72,    72,    72,    72,    72,    72,   -64,     8
   -64,    72,    72,    72,    72,    72,    72,    72,    72,    72,    72,    72,    72,    72,    72,    72,    72,    72,    72,    72,    72,    72,    72,    72,    72,    72,   -64,     8
    96,    96,    96,    96,    96,    96,    96,    96,    96,    96,    96,    96,    96,    96,   -64,    72,    72,    72,   -64,    96,    96,    96,    96,    96,    96,    96,    96,     8
    8,     8,     8,     8,     8,     8,     8,     8,     8,     8,     8,     8,     8,     8,   -64,    72,    72,    72,   -64,     8,     8,     8,     8,     8,     8,     8,     8,     8