31
25
0,0,0,0,0,0,0,0,0,0,0,0,0,74,74,74,0,0,0,0,0,0,0,0,0,-1350,-1414,-1415,-1414,-1415
0,0,0,0,0,0,0,0,0,0,0,0,0,74,74,74,0,-660,-661,-660,-661,0,0,0,0,-1382,-1446,-1447,-1446,-1447
0,0,0,0,0,0,0,0,0,0,0,0,0,74,74,74,0,-692,-693,-692,-693,0,0,0,0,-1350,-1414,-1415,-1414,-1415
0,0,0,0,0,0,0,0,-660,-661,-660,-661,0,74,74,74,0,-834,-833,-724,-709,0,0,0,0,-1382,-1446,-1447,-1446,-1447
0,0,0,0,0,0,0,0,-692,-693,-692,-693,0,74,74,74,0,-681,-681,-756,-757,-1420,-1423,-1422,0,0,-1382,-1383,-1382,-1383
0,0,0,0,0,-1332,-1301,-1302,-590,-591,-724,-736,0,74,74,74,74,74,74,74,74,74,74,74,74,74,0,0,0,0
0,0,0,0,0,-1332,-1333,-1334,-686,-687,-756,-680,0,74,74,74,74,74,74,74,74,74,74,74,74,74,0,0,0,0
0,0,0,74,74,74,74,74,74,74,74,74,74,74,74,74,0,0,0,0,0,0,0,0,0,0,0,0,0,0
0,0,0,74,74,74,74,74,74,74,74,74,74,74,74,74,0,0,0,0,0,0,0,0,0,0,0,0,0,0
0,0,0,0,0,0,0,0,0,0,0,0,0,74,74,74,0,0,0,0,0,0,0,0,0,0,0,0,0,0
0,0,0,0,0,0,0,0,0,0,0,0,0,74,74,74,0,0,0,0,0,-660,-661,-660,-661,0,0,0,0,0
0,0,0,0,0,0,0,0,0,0,0,0,0,74,74,74,0,0,0,0,0,-692,-693,-692,-693,0,0,0,0,0
0,0,0,-660,-661,-660,-661,0,0,0,0,0,0,74,74,74,0,0,0,-1274,-1274,-590,-591,-724,-707,0,0,0,0,0
0,0,0,-692,-693,-692,-693,0,0,0,0,0,0,74,74,74,0,0,0,-1502,-1503,-654,-655,-756,-757,0,0,0,0,0
0,0,-1823,-834,-834,-725,-705,-1146,0,0,0,0,0,74,74,74,74,74,74,74,74,74,74,74,74,0,0,0,0,0
0,0,-1855,-756,-757,-680,-681,-1178,-1274,0,0,0,0,74,74,74,74,74,74,74,74,74,74,74,74,0,0,0,0,0
0,0,74,74,74,74,74,74,74,74,74,74,74,74,74,74,0,0,0,0,0,0,0,0,0,0,0,0,0,0
0,0,74,74,74,74,74,74,74,74,74,74,74,74,74,74,0,0,0,0,0,0,0,0,0,0,0,0,0,0
0,0,0,0,0,0,0,0,0,0,0,0,0,74,74,74,0,0,0,0,0,0,0,0,0,0,0,0,0,0
0,0,0,0,0,0,0,0,0,0,0,0,0,74,74,74,0,0,0,0,0,0,0,0,0,0,0,0,0,0
0,0,0,0,0,0,0,0,0,0,0,0,0,74,74,74,0,0,0,0,0,0,0,0,0,0,0,0,0,0
0,0,0,0,0,0,0,0,0,0,0,0,0,74,74,74,0,0,0,0,0,0,0,0,0,0,0,0,0,0
0,0,0,0,0,0,0,0,0,0,0,0,0,74,74,74,0,0,0,0,0,0,0,0,0,0,0,0,0,0
0,0,0,0,0,0,0,0,0,0,0,0,0,74,74,74,0,0,0,0,0,0,0,0,0,0,0,0,0,0
0,0,0,0,0,0,0,0,0,0,0,0,0,74,74,74,0,0,0,0,0,0,0,0,0,0,0,0,0,0