31
25
0,0,0,0,0,0,0,0,0,0,0,0,0,74,74,74,0,0,0,0,0,0,0,0,0,-1350,-1414,-1415,-1414,-1415
0,0,0,0,0,0,0,0,0,0,0,0,0,74,74,74,0,-660,-661,-660,-661,0,0,0,0,-1382,-1446,-1447,-1446,-1447
0,0,0,0,0,0,0,0,0,0,0,0,0,74,74,74,0,-692,-693,-692,-693,0,0,0,0,-1350,-1414,-1415,-1414,-1415
0,0,0,0,0,0,0,0,-660,-661,-660,-661,0,74,74,74,0,-04,-05,-04,-05,0,0,0,0,-1382,-1446,-1447,-1446,-1447
0,0,0,0,0,0,0,0,-692,-693,-692,-693,0,74,74,74,0,-756,-757,-756,-757,-1420,-1423,-1422,0,0,-1382,-1383,-1382,-1383
0,0,0,0,0,-1332,-1301,-1302,-724,-725,-724,-725,0,74,74,74,74,74,74,74,74,74,74,74,74,74,0,0,0,0
0,0,0,0,0,-1332,-1333,-1334,-756,-757,-756,-757,0,74,74,74,74,74,74,74,74,74,74,74,74,74,0,0,0,0
0,0,0,74,74,74,74,74,74,74,74,74,74,74,74,74,0,0,0,0,0,0,0,0,0,0,0,0,0,0
0,0,0,74,74,74,74,74,74,74,74,74,74,74,74,74,0,0,0,0,0,0,0,0,0,0,0,0,0,0
0,0,0,0,0,0,0,0,0,0,0,0,0,74,74,74,0,0,0,0,0,0,0,0,0,0,0,0,0,0
0,0,0,0,0,0,0,0,0,0,0,0,0,74,74,74,0,0,0,0,0,-660,-661,-660,-661,0,0,0,0,0
0,0,0,0,0,0,0,0,0,0,0,0,0,74,74,74,0,0,0,0,0,-692,-693,-692,-693,0,0,0,0,0
0,0,0,-660,-661,-660,-661,0,0,0,0,0,0,74,74,74,0,0,0,-1274,-1274,-724,-725,-724,-725,0,0,0,0,0
0,0,0,-692,-693,-692,-693,0,0,0,0,0,0,74,74,74,0,0,0,-1502,-1503,-756,-757,-756,-757,0,0,0,0,0
0,0,-1823,-724,-725,-724,-725,-1146,0,0,0,0,0,74,74,74,74,74,74,74,74,74,74,74,74,0,0,0,0,0
0,0,-1855,-756,-757,-756,-757,-1178,-1274,0,0,0,0,74,74,74,74,74,74,74,74,74,74,74,74,0,0,0,0,0
0,0,74,74,74,74,74,74,74,74,74,74,74,74,74,74,0,0,0,0,0,0,0,0,0,0,0,0,0,0
0,0,74,74,74,74,74,74,74,74,74,74,74,74,74,74,0,0,0,0,0,0,0,0,0,0,0,0,0,0
0,0,0,0,0,0,0,0,0,0,0,0,0,74,74,74,0,0,0,0,0,0,0,0,0,0,0,0,0,1186
0,0,0,0,0,0,0,0,0,0,0,0,0,74,74,74,0,0,0,0,0,0,0,0,0,0,0,0,0,1186
0,0,0,0,0,0,0,0,0,0,0,0,0,74,74,74,0,0,0,0,0,0,0,0,0,0,0,0,0,0
0,0,0,0,0,0,0,0,0,0,0,0,0,74,74,74,0,0,0,0,0,0,0,0,0,0,0,0,0,0
0,0,0,0,0,0,0,0,0,0,0,0,0,74,74,74,0,0,0,0,0,0,0,0,0,0,0,0,0,0
0,0,0,0,0,0,0,0,0,0,0,0,0,74,74,74,0,0,0,0,0,0,0,0,0,0,0,0,0,0
0,0,0,0,0,0,0,0,0,0,0,0,0,74,74,74,0,0,0,0,0,0,0,0,0,0,0,0,0,0