31
25
72,    72,    72,    72,    72,    72,    72,    72,    72,    72,    72,    72,    72,    74,    74,    74,    72,    72,    72,    72,    72,    72,    72,    72,    72,   -72,   -72,   -72,   -72,  -72
72,    72,    72,    72,    72,    72,    72,    72,    72,    72,    72,    72,    72,    74,    74,    74,    72,    72,    72,    72,    72,    72,    72,    72,    72,   -72,   -72,   -72,   -72,  -72
72,    72,    72,    72,    72,    72,    72,    72,    72,    72,    72,    72,    72,    74,    74,    74,    72,    72,    72,    72,    72,    72,    72,    72,    72,   -72,   -72,   -72,   -72,  -72
72,    72,    72,    72,    72,    72,    72,    72,   -72,   -72,   -72,   -72,    72,    74,    74,    74,    72,    72,    72,    72,   -72,   -72,   -72,   -72,   -72,   -72,   -72,   -72,   -72,  -72
72,    72,    72,    72,    72,    72,    72,    72,   -72,   -72,   -72,   -72,    72,    74,    74,    74,    72,   -72,   -72,   -72,   -72,   -72,   -72,   -72,    72,    72,   -72,   -72,   -72,  -72
72,    72,    72,    72,    72,    72,    72,    72,   -72,   -72,   -72,   -72,    72,    74,    74,    74,    74,    74,    74,    74,    74,    74,    72,    72,    72,    72,    72,    72,    72,   72
72,    72,    72,    72,    72,    72,    72,    72,   -72,   -72,   -72,   -72,    72,    74,    74,    74,    72,    72,    72,    72,    72,    72,    72,    72,    72,    72,    72,    72,    72,   72
72,    72,    72,    74,    74,    74,    74,    74,    74,    74,    74,    74,    74,    74,    74,    74,    72,    72,    72,    72,    72,    72,    72,    72,    72,    72,    72,    72,    72,   72
72,    72,    72,    74,    74,    74,    74,    74,    74,    74,    74,    74,    74,    74,    74,    74,    72,    72,    72,    72,    72,    72,    72,    72,    72,    72,    72,    72,    72,   72
72,    72,    72,    72,    72,    72,    72,    72,    72,    72,    72,    72,    72,    74,    74,    74,    72,    72,    72,    72,    72,    72,    72,    72,    72,    72,    72,    72,    72,   72
72,    72,    72,    72,    72,    72,    72,    72,    72,    72,    72,    72,    72,    74,    74,    74,    72,    72,    72,    72,    72,    72,    72,    72,    72,    72,    72,    72,    72,   72
72,    72,    72,    72,    72,    72,    72,    72,    72,    72,    72,    72,    72,    74,    74,    74,    72,    72,    72,    72,    72,    72,    72,    72,    72,    72,    72,    72,    72,   72
72,    72,    72,    72,    72,    72,    72,    72,    72,    72,    72,    72,    72,    74,    74,    74,    72,    72,    72,    72,    72,    72,    72,    72,    72,    72,    72,    72,    72,   72
72,    72,    72,    72,    72,    72,    72,    72,    72,    72,    72,    72,    72,    74,    74,    74,    72,    72,    72,    72,    72,    72,    72,    72,    72,    72,    72,    72,    72,   72
72,    72,    72,    72,    72,    72,    72,    72,    72,    72,    72,    72,    72,    74,    74,    74,    74,    74,    74,    74,    74,    74,    74,    74,    74,    72,    72,    72,    72,   72
72,    72,    72,    72,    72,    72,    72,    72,    72,    72,    72,    72,    72,    74,    74,    74,    72,    72,    72,    72,    72,    72,    72,    72,    72,    72,    72,    72,    72,   72
72,    72,    72,    74,    74,    74,    74,    74,    74,    74,    74,    74,    74,    74,    74,    74,    72,    72,    72,    72,    72,    72,    72,    72,    72,    72,    72,    72,    72,   72
72,    72,    72,    72,    72,    72,    72,    72,    72,    72,    72,    72,    72,    74,    74,    74,    72,    72,    72,    72,    72,    72,    72,    72,    72,    72,    72,    72,    72,   72
72,    72,    72,    72,    72,    72,    72,    72,    72,    72,    72,    72,    72,    74,    74,    74,    72,    72,    72,    72,    72,    72,    72,    72,    72,    72,    72,    72,    72,   72
72,    72,    72,    72,    72,    72,    72,    72,    72,    72,    72,    72,    72,    74,    74,    74,    72,    72,    72,    72,    72,    72,    72,    72,    72,    72,    72,    72,    72,   72
72,    72,    72,    72,    72,    72,    72,    72,    72,    72,    72,    72,    72,    74,    74,    74,    72,    72,    72,    72,    72,    72,    72,    72,    72,    72,    72,    72,    72,   72
72,    72,    72,    72,    72,    72,    72,    72,    72,    72,    72,    72,    72,    74,    74,    74,    72,    72,    72,    72,    72,    72,    72,    72,    72,    72,    72,    72,    72,   72
72,    72,    72,    72,    72,    72,    72,    72,    72,    72,    72,    72,    72,    74,    74,    74,    72,    72,    72,    72,    72,    72,    72,    72,    72,    72,    72,    72,    72,   72
72,    72,    72,    72,    72,    72,    72,    72,    72,    72,    72,    72,    72,    74,    74,    74,    72,    72,    72,    72,    72,    72,    72,    72,    72,    72,    72,    72,    72,   72
72,    72,    72,    72,    72,    72,    72,    72,    72,    72,    72,    72,    72,    74,    74,    74,    72,    72,    72,    72,    72,    72,    72,    72,    72,    72,    72,    72,    72,    72