31
25
72,72,72,72,72,72,72,72,72,72,72,72,72,74,74,74,72,72,72,72,72,72,72,72,72,-72,-72,-72,-72,-72
72,72,72,72,72,72,72,72,72,72,72,72,72,74,74,74,72,72,72,72,72,72,72,72,72,-72,-72,-72,-72,-72
72,72,72,72,72,72,72,72,72,72,72,72,72,74,74,74,72,72,72,72,72,72,72,72,72,-72,-72,-72,-72,-72
72,72,72,72,72,72,72,72,-72,-72,-72,-72,72,74,74,74,72,72,72,72,72,72,72,72,-72,-72,-72,-72,-72,-72
72,72,72,72,72,72,72,72,-72,-72,-72,-72,72,74,74,74,72,-72,-72,-72,-72,-72,-72,-72,72,72,-72,-72,-72,-72
72,72,72,72,72,72,72,72,-72,-72,-72,-72,72,74,74,74,74,74,74,74,74,74,72,72,72,72,72,72,72,72
72,72,72,72,72,72,72,72,-72,-72,-72,-72,72,74,74,74,72,72,72,72,72,72,72,72,72,72,72,72,72,72
72,72,72,74,74,74,74,74,74,74,74,74,74,74,74,74,72,72,72,72,72,72,72,72,72,72,72,72,72,72
72,72,72,74,74,74,74,74,74,74,74,74,74,74,74,74,72,72,72,72,72,72,72,72,72,72,72,72,72,72
72,72,72,72,72,72,72,72,72,72,72,72,72,74,74,74,72,72,72,72,72,72,72,72,72,72,72,72,72,72
72,72,72,72,72,72,72,72,72,72,72,72,72,74,74,74,72,72,72,72,72,72,72,72,72,72,72,72,72,72
72,72,72,72,72,72,72,72,72,72,72,72,72,74,74,74,72,72,72,72,72,72,72,72,72,72,72,72,72,72
72,72,72,72,72,72,72,72,72,72,72,72,72,74,74,74,72,72,72,72,72,72,72,72,72,72,72,72,72,72
72,72,72,72,72,72,72,72,72,72,72,72,72,74,74,74,72,72,72,72,72,72,72,72,72,72,72,72,72,72
72,72,72,724,725,724,725,72,72,72,72,72,72,74,74,74,74,74,74,74,74,74,74,74,74,72,72,72,72,72
72,72,72,756,757,756,757,72,72,72,72,72,72,74,74,74,72,72,72,72,72,72,72,72,72,72,72,72,72,72
72,72,72,74,74,74,74,74,74,74,74,74,74,74,74,74,72,72,72,72,72,72,72,72,72,72,72,72,72,72
72,72,72,72,72,72,72,72,72,72,72,72,72,74,74,74,72,72,72,72,72,72,72,72,72,72,72,72,72,72
72,72,72,72,72,72,72,72,72,72,72,72,72,74,74,74,72,72,72,72,72,72,72,72,72,72,72,72,72,72
72,72,72,72,72,72,72,72,72,72,72,72,72,74,74,74,72,72,72,72,72,72,72,72,72,72,72,72,72,72
72,72,72,72,72,72,72,72,72,72,72,72,72,74,74,74,72,72,72,72,72,72,72,72,72,72,72,72,72,72
72,72,72,72,72,72,72,72,72,72,72,72,72,74,74,74,72,72,72,72,72,72,72,72,72,72,72,72,72,72
72,72,72,72,72,72,72,72,72,72,72,72,72,74,74,74,72,72,72,72,72,72,72,72,72,72,72,72,72,72
72,72,72,72,72,72,72,72,72,72,72,72,72,74,74,74,72,72,72,72,72,72,72,72,72,72,72,72,72,72
72,72,72,72,72,72,72,72,72,72,72,72,72,74,74,74,72,72,72,72,72,72,72,72,72,72,72,72,72,72